NO ./texture/path_to_the_north_texture
SO ./texture/path_to_the_south_texture
WE ./texture/path_to_the_west_texture
EA ./texture/path_to_the_east_texture

F 62,62,62
C 0,191,255

11111111 111111 
10010111 100011
1010011 1101111
1100E11 1000001
1111111 1111111
