NO ./path_to_the_north_texture
SO ./path_to_the_south_texture
WE ./path_to_the_west_texture
EA ./path_to_the_east_texture

F 62,62,62
C 0,191,255

1111111 11111111 
1001011 11100011
101001 1111101111
1100E11 110000001
11111111 1111111
