NO ./path_to_the_north_texture
SO ./path_to_the_south_texture
WE ./path_to_the_west_texture
EA ./path_to_the_east_texture

F 255,239,3
C 167,50,2

111111
100101
101001
1100E1
111111