NO ./texture/path_to_the_north_texture
SO ./texture/path_to_the_south_texture
WE ./texture/path_to_the_west_texture
EA ./texture/path_to_the_east_texture

F 62,62,62
C 0,191,255

111111111111111 
100101111100011
101001111101111
1100E1111000001
111111111111111
