NO ./texture/path_to_the_north_texture
SO ./texture/path_to_the_south_texture
WE ./texture/path_to_the_west_texture
EA ./texture/path_to_the_east_texture

F 62,62,62
C 0,191,255

1111111111111111111111111
1000000000000000111111111
1111111111011100000000001
1000000000010111111111111
1111011111110000000000011
1000010000011111111111011
1111011101110000000000011
1000000000000111111111011
1111111111111000001000001
1000000001001111111101111
1011111111010000000000011
1S00000000000111111111111
1111111111111111111111111
