NO                    ./texture/path_to_the_north_texture
SO ./texture/path_to_the_south_texture
WE                ./texture/path_to_the_west_texture
WE                ./texture/path_to_the_west_texture

F 255,237,0
EA           ./texture/path_to_the_east_texture
C               0,45,114

                      1111111111111111111111111
                      1011000001110000000000001
                      10000000000000000000000011 
              111111111011000001110000000000001
              100000000011000001110111111111111111
              11110111111111011100000010001
              11110111111111N111010100100011111111
              110000001101010111000000100011100001
              10000000000000011000000100011111101
              1100000011010101110000001000111011
              110000001101010111000000100011111111
              1000000000000000110101001000111111111
              1100000111010101111101111000111
              11110111 1110101 101111010001
              11111111 1111111 111111111111



















