NO                    ./texture/path_to_the_north_texture










C                 0,191,255
SO          ./texture/path_to_the_south_texture
WE                ./texture/path_to_the_west_texture












F              62,62,62
EA           ./texture/path_to_the_east_texture


                      1111111111111111111111111
                      1011000001110000000000001
                      10000000000000000000000011 
              1111111110110000011100000000000011
              100000000011000001110111111111111111
              11110111111111011100000010001
              11110111111111011101010010001
              11000000110101011100000010001 
              1N000000000000001100000010001
              11000000110101011100000010001 
              11000000110101011100000010001 
              10000000000000001101010010001
              1100000111010101111101111000111
              11110111 1110101 101111010001
              11111111 1111111 111111111111
















